10101010
11111110
10000001
10101000
00000001
